....................
..__........_f__....
....................
....................
..f_................
.............._f3....
....................
.......R...__.......
....................
--------------------