2..............T....
..._f__........__...
....................
.....M.........._f_.
.....___............
............_f__....
....................
............___..B..
....................
--------------------
