2..............R....
..._f__........__...
....................
.....R.........._f_.
.....___............
............_f__....
....................
............___..R..
....................
--------------------
