....................
...........____.....
....................
...........___......
..___...............
....................
....................
..........___....R..
.................R..
H................R..
