1.............T.....
..........._f__.....
....................
..........._f_......
.._f_...............
....................
.......M............
..........___.......
.................B..
--------------------