1.............R.....
..........._f__.....
....................
..........._f_......
.._f_...............
....................
.......R............
..........___.......
.................R..
--------------------